###############
#P...........#
#...####.....#
#...#S.#.....#
#...D#.#.....#
#....#S#.....#
#....#.#.....#
#....#.#.....#
#....#D#.....#
#...........E#
############### 