######################
#....................#
#....................#
#..S...........S.....#
#....................#
#....................#
#####D#######D#######
#....................#
#....................#
#....................#
#........S...........#
#....................#
#######D############D#
#....................#
#...............E....#
###################### 