###############
#P..........D#
#............#
#...##S##....#
#....#.#.....#
#....#.#.....#
#....#S#.....#
#............#
#............#
#...........E#
############### 