###############
#P...........#
#.....S.......
#............#
#.....#######D
#............#
#............#
#............#
#............#
#...........E#
############### 