###############
#.............#
#.............#
#....#####....#
#....#...#....#
#....#.S.#....#
#....#...#....#
#....##D##....#
#.............#
#.............#
#.............#
#.............#
#.......E.....#
############### 